5 10
1 9 3 0
##########
########00
########0#
000000000#
##########
