7 58
1 57 5 0
##########################################################
#000000000000000000000000000000000000000000000000000000000
#0########################################################
#00000000000000000000000000000000000000000000000000000000#
########################################################0#
000000000000000000000000000000000000000000000000000000000#
##########################################################
