7 17
1 0 5 0
#################
0000000000000000#
#000000000000000#
#000000000000000#
#000000000000000#
0000000000000000#
#################
