13 31
0 3 8 30 
###0###########################
##000###0000###000000000000####
###000##0##0###0##########0####
#####0##0##0###00000##00##0####
##0000000##0#0#####0##0###0####
##0########0000000000000000####
##0000#####0#######0##0###0####
#####0#####0000####0##0###0####
#####0########0####0##0###00000
###000###00000####0000####0####
#######0000########0######0####
####0000##0000000000##00000####
###############################
