7 17
0 1 3 16
#0###############
#000000000000000#
#000000000000000#
#0000000000000000
#000000000000000#
#000000000000000#
#################
