7 17
1 0 5 16
#################
0000000000000000#
#000000000000000#
#000000000000000#
#000000000000000#
#0000000000000000
#################
