7 14
0 1 6 12
#0############
#0#0000#00000#
#0#0##0#0###0#
#0#0##0#000#0#
#0#0##0###0#0#
#000##00000#0#
############0#
